
                                      XXXXXXXXXXXXXXXXXXXXXXXXXXXXXXXXXXXX
									  X1111111111111111111111111111111111X
                                      X1111111111111111111111111111111111X
                                      X111XXXXXXXXXXXXXXXXXXXXXXX11111111X
XXXXXXXXXXXXXXXXXXXXXXXXXXXXXXXXXX    X111X                  X11111111111X
X111111111111111X1111111111111111X    X111X    XXXXXXXXXXXX  X11111111111X
X11111111111111111111111111111111X    X111X    X1111111111X  X11111XX1111X
X1111X11111X111111111111111111111XXXXXX111XXXXXX1111111111X  X11111XX1111X
X111111111111111X1111111111111111X1111111111111X1111111111X  X11111111111X
X1111X11111X1111X111111111111111111111111111111X1111111111X  X11111111111X
X111111111111111X11111111111111111111111111111111111111111X  XXXXXXXXXXXXX
X111111111111111X1111111111111111X111111111111111111111111X
XXXXXXXXXXXXXXXXX11XXXXXXXX11XXXXXXXXXXXXXXXXXXXXXXXXXXXXXX
				X11X      X11X
				X11X      X11X           XXXXXXXXXXXXXXXXXXXXXXXXX
				X11X      X11X           X111111111111X1111111111X
				X11X      X11XXXXXXXXXXXXX111111111111X1111111111X
				X11X      X111111111111111111111111111X1111111111X
				X11X      X111111111111111111111111111X1111111111X
				X11X      XXXXXXXXXXXXXXXXXXXXXX1111XXXX11111XXXXX
XXXXXXXXXXXXXXXXX11X                     X11111111111111111111111X
X111111111111111111X                     X1111111111111111XX11111X
X111111111111111111XXXXXXXXXXXXXXXXXXXXXXX1111111111111111XX11111X
X1111111111111111111111111111111111111111111111111111111111111111X
XXXXXXXXXXXXXXXXXXXXXXXXXXXXXXXX111XXXXXXXXXXXXXXXXXXXXXXXXEEEEXXX
							X111111111111111111111111X
							X111111111111111111111111X
							XXXXXXXXXXXXXXXXXXXXXXXXXX